size = 50
numRows = 10
numCols = 34
##################################
#P                               #
#                                #
#                                #
#                                #
#                                #
#                      B         #
#                                #
#                                #
#                                #
#                              F #
##################################