size = 50
numRows = 12
numCols = 18
dx = 2
dy = 2
scoreReq = 3
##################
#P     @@@@@@@@@@#
##           @  @#
##########   @  @#
#   J        @  @#
#@           @   #
#@       E   @   #
#@   S           #
#@               #
#@@@@@@@@@@@@@@#*#
#       #####  F #
##################